Month,Starting Balance,Repayment,Interest Paid,Principal Paid,New Balance,Mortgage Name,Interest Rate
1,400000.0,1686.42,1000.0,686.42,399313.58,30 Year,0.03
2,399313.58,1686.42,998.28,688.14,398625.44,30 Year,0.03
3,398625.44,1686.42,996.56,689.86,397935.58,30 Year,0.03
4,397935.58,1686.42,994.83,691.59,397243.99,30 Year,0.03
5,397243.99,1686.42,993.1,693.32,396550.67,30 Year,0.03
6,396550.67,1686.42,991.37,695.05,395855.62,30 Year,0.03
7,395855.62,1686.42,989.63,696.79,395158.83,30 Year,0.03
8,395158.83,1686.42,987.89,698.53,394460.3,30 Year,0.03
9,394460.3,1686.42,986.15,700.27,393760.03,30 Year,0.03
10,393760.03,1686.42,984.4,702.02,393058.01,30 Year,0.03
11,393058.01,1686.42,982.64,703.78,392354.23,30 Year,0.03
12,392354.23,1686.42,980.88,705.54,391648.69,30 Year,0.03
13,391648.69,1686.42,979.12,707.3,390941.39,30 Year,0.03
14,390941.39,1686.42,977.35,709.07,390232.32,30 Year,0.03
15,390232.32,1686.42,975.58,710.84,389521.48,30 Year,0.03
16,389521.48,1686.42,973.8,712.62,388808.86,30 Year,0.03
17,388808.86,1686.42,972.02,714.4,388094.46,30 Year,0.03
18,388094.46,1686.42,970.23,716.19,387378.27,30 Year,0.03
19,387378.27,1686.42,968.44,717.98,386660.29,30 Year,0.03
20,386660.29,1686.42,966.65,719.77,385940.52,30 Year,0.03
21,385940.52,1686.42,964.85,721.57,385218.95,30 Year,0.03
22,385218.95,1686.42,963.04,723.38,384495.57,30 Year,0.03
23,384495.57,1686.42,961.23,725.19,383770.38,30 Year,0.03
24,383770.38,1686.42,959.42,727.0,383043.38,30 Year,0.03
25,383043.38,1686.42,957.6,728.82,382314.56,30 Year,0.03
26,382314.56,1686.42,955.78,730.64,381583.92,30 Year,0.03
27,381583.92,1686.42,953.95,732.47,380851.45,30 Year,0.03
28,380851.45,1686.42,952.12,734.3,380117.15,30 Year,0.03
29,380117.15,1686.42,950.29,736.13,379381.02,30 Year,0.03
30,379381.02,1686.42,948.45,737.97,378643.05,30 Year,0.03
31,378643.05,1686.42,946.6,739.82,377903.23,30 Year,0.03
32,377903.23,1686.42,944.75,741.67,377161.56,30 Year,0.03
33,377161.56,1686.42,942.9,743.52,376418.04,30 Year,0.03
34,376418.04,1686.42,941.04,745.38,375672.66,30 Year,0.03
35,375672.66,1686.42,939.18,747.24,374925.42,30 Year,0.03
36,374925.42,1686.42,937.31,749.11,374176.31,30 Year,0.03
37,374176.31,1686.42,935.44,750.98,373425.33,30 Year,0.03
38,373425.33,1686.42,933.56,752.86,372672.47,30 Year,0.03
39,372672.47,1686.42,931.68,754.74,371917.73,30 Year,0.03
40,371917.73,1686.42,929.79,756.63,371161.1,30 Year,0.03
41,371161.1,1686.42,927.9,758.52,370402.58,30 Year,0.03
42,370402.58,1686.42,926.0,760.42,369642.16,30 Year,0.03
43,369642.16,1686.42,924.1,762.32,368879.84,30 Year,0.03
44,368879.84,1686.42,922.19,764.23,368115.61,30 Year,0.03
45,368115.61,1686.42,920.28,766.14,367349.47,30 Year,0.03
46,367349.47,1686.42,918.37,768.05,366581.42,30 Year,0.03
47,366581.42,1686.42,916.45,769.97,365811.45,30 Year,0.03
48,365811.45,1686.42,914.52,771.9,365039.55,30 Year,0.03
49,365039.55,1686.42,912.59,773.83,364265.72,30 Year,0.03
50,364265.72,1686.42,910.66,775.76,363489.96,30 Year,0.03
51,363489.96,1686.42,908.72,777.7,362712.26,30 Year,0.03
52,362712.26,1686.42,906.78,779.64,361932.62,30 Year,0.03
53,361932.62,1686.42,904.83,781.59,361151.03,30 Year,0.03
54,361151.03,1686.42,902.87,783.55,360367.48,30 Year,0.03
55,360367.48,1686.42,900.91,785.51,359581.97,30 Year,0.03
56,359581.97,1686.42,898.95,787.47,358794.5,30 Year,0.03
57,358794.5,1686.42,896.98,789.44,358005.06,30 Year,0.03
58,358005.06,1686.42,895.01,791.41,357213.65,30 Year,0.03
59,357213.65,1686.42,893.03,793.39,356420.26,30 Year,0.03
60,356420.26,1686.42,891.05,795.37,355624.89,30 Year,0.03
61,355624.89,1686.42,889.06,797.36,354827.53,30 Year,0.03
62,354827.53,1686.42,887.06,799.36,354028.17,30 Year,0.03
63,354028.17,1686.42,885.07,801.35,353226.82,30 Year,0.03
64,353226.82,1686.42,883.06,803.36,352423.46,30 Year,0.03
65,352423.46,1686.42,881.05,805.37,351618.09,30 Year,0.03
66,351618.09,1686.42,879.04,807.38,350810.71,30 Year,0.03
67,350810.71,1686.42,877.02,809.4,350001.31,30 Year,0.03
68,350001.31,1686.42,875.0,811.42,349189.89,30 Year,0.03
69,349189.89,1686.42,872.97,813.45,348376.44,30 Year,0.03
70,348376.44,1686.42,870.94,815.48,347560.96,30 Year,0.03
71,347560.96,1686.42,868.9,817.52,346743.44,30 Year,0.03
72,346743.44,1686.42,866.85,819.57,345923.87,30 Year,0.03
73,345923.87,1686.42,864.8,821.62,345102.25,30 Year,0.03
74,345102.25,1686.42,862.75,823.67,344278.58,30 Year,0.03
75,344278.58,1686.42,860.69,825.73,343452.85,30 Year,0.03
76,343452.85,1686.42,858.63,827.79,342625.06,30 Year,0.03
77,342625.06,1686.42,856.56,829.86,341795.2,30 Year,0.03
78,341795.2,1686.42,854.48,831.94,340963.26,30 Year,0.03
79,340963.26,1686.42,852.4,834.02,340129.24,30 Year,0.03
80,340129.24,1686.42,850.32,836.1,339293.14,30 Year,0.03
81,339293.14,1686.42,848.23,838.19,338454.95,30 Year,0.03
82,338454.95,1686.42,846.13,840.29,337614.66,30 Year,0.03
83,337614.66,1686.42,844.03,842.39,336772.27,30 Year,0.03
84,336772.27,1686.42,841.93,844.49,335927.78,30 Year,0.03
85,335927.78,1686.42,839.81,846.61,335081.17,30 Year,0.03
86,335081.17,1686.42,837.7,848.72,334232.45,30 Year,0.03
87,334232.45,1686.42,835.58,850.84,333381.61,30 Year,0.03
88,333381.61,1686.42,833.45,852.97,332528.64,30 Year,0.03
89,332528.64,1686.42,831.32,855.1,331673.54,30 Year,0.03
90,331673.54,1686.42,829.18,857.24,330816.3,30 Year,0.03
91,330816.3,1686.42,827.04,859.38,329956.92,30 Year,0.03
92,329956.92,1686.42,824.89,861.53,329095.39,30 Year,0.03
93,329095.39,1686.42,822.73,863.69,328231.7,30 Year,0.03
94,328231.7,1686.42,820.57,865.85,327365.85,30 Year,0.03
95,327365.85,1686.42,818.41,868.01,326497.84,30 Year,0.03
96,326497.84,1686.42,816.24,870.18,325627.66,30 Year,0.03
97,325627.66,1686.42,814.06,872.36,324755.3,30 Year,0.03
98,324755.3,1686.42,811.88,874.54,323880.76,30 Year,0.03
99,323880.76,1686.42,809.7,876.72,323004.04,30 Year,0.03
100,323004.04,1686.42,807.51,878.91,322125.13,30 Year,0.03
101,322125.13,1686.42,805.31,881.11,321244.02,30 Year,0.03
102,321244.02,1686.42,803.11,883.31,320360.71,30 Year,0.03
103,320360.71,1686.42,800.9,885.52,319475.19,30 Year,0.03
104,319475.19,1686.42,798.68,887.74,318587.45,30 Year,0.03
105,318587.45,1686.42,796.46,889.96,317697.49,30 Year,0.03
106,317697.49,1686.42,794.24,892.18,316805.31,30 Year,0.03
107,316805.31,1686.42,792.01,894.41,315910.9,30 Year,0.03
108,315910.9,1686.42,789.77,896.65,315014.25,30 Year,0.03
109,315014.25,1686.42,787.53,898.89,314115.36,30 Year,0.03
110,314115.36,1686.42,785.28,901.14,313214.22,30 Year,0.03
111,313214.22,1686.42,783.03,903.39,312310.83,30 Year,0.03
112,312310.83,1686.42,780.77,905.65,311405.18,30 Year,0.03
113,311405.18,1686.42,778.51,907.91,310497.27,30 Year,0.03
114,310497.27,1686.42,776.24,910.18,309587.09,30 Year,0.03
115,309587.09,1686.42,773.96,912.46,308674.63,30 Year,0.03
116,308674.63,1686.42,771.68,914.74,307759.89,30 Year,0.03
117,307759.89,1686.42,769.39,917.03,306842.86,30 Year,0.03
118,306842.86,1686.42,767.1,919.32,305923.54,30 Year,0.03
119,305923.54,1686.42,764.8,921.62,305001.92,30 Year,0.03
120,305001.92,1686.42,762.5,923.92,304078.0,30 Year,0.03
121,304078.0,1686.42,760.19,926.23,303151.77,30 Year,0.03
122,303151.77,1686.42,757.87,928.55,302223.22,30 Year,0.03
123,302223.22,1686.42,755.55,930.87,301292.35,30 Year,0.03
124,301292.35,1686.42,753.23,933.19,300359.16,30 Year,0.03
125,300359.16,1686.42,750.89,935.53,299423.63,30 Year,0.03
126,299423.63,1686.42,748.55,937.87,298485.76,30 Year,0.03
127,298485.76,1686.42,746.21,940.21,297545.55,30 Year,0.03
128,297545.55,1686.42,743.86,942.56,296602.99,30 Year,0.03
129,296602.99,1686.42,741.5,944.92,295658.07,30 Year,0.03
130,295658.07,1686.42,739.14,947.28,294710.79,30 Year,0.03
131,294710.79,1686.42,736.77,949.65,293761.14,30 Year,0.03
132,293761.14,1686.42,734.4,952.02,292809.12,30 Year,0.03
133,292809.12,1686.42,732.02,954.4,291854.72,30 Year,0.03
134,291854.72,1686.42,729.63,956.79,290897.93,30 Year,0.03
135,290897.93,1686.42,727.24,959.18,289938.75,30 Year,0.03
136,289938.75,1686.42,724.84,961.58,288977.17,30 Year,0.03
137,288977.17,1686.42,722.44,963.98,288013.19,30 Year,0.03
138,288013.19,1686.42,720.03,966.39,287046.8,30 Year,0.03
139,287046.8,1686.42,717.61,968.81,286077.99,30 Year,0.03
140,286077.99,1686.42,715.19,971.23,285106.76,30 Year,0.03
141,285106.76,1686.42,712.76,973.66,284133.1,30 Year,0.03
142,284133.1,1686.42,710.33,976.09,283157.01,30 Year,0.03
143,283157.01,1686.42,707.89,978.53,282178.48,30 Year,0.03
144,282178.48,1686.42,705.44,980.98,281197.5,30 Year,0.03
145,281197.5,1686.42,702.99,983.43,280214.07,30 Year,0.03
146,280214.07,1686.42,700.53,985.89,279228.18,30 Year,0.03
147,279228.18,1686.42,698.07,988.35,278239.83,30 Year,0.03
148,278239.83,1686.42,695.59,990.83,277249.0,30 Year,0.03
149,277249.0,1686.42,693.12,993.3,276255.7,30 Year,0.03
150,276255.7,1686.42,690.63,995.79,275259.91,30 Year,0.03
151,275259.91,1686.42,688.14,998.28,274261.63,30 Year,0.03
152,274261.63,1686.42,685.65,1000.77,273260.86,30 Year,0.03
153,273260.86,1686.42,683.15,1003.27,272257.59,30 Year,0.03
154,272257.59,1686.42,680.64,1005.78,271251.81,30 Year,0.03
155,271251.81,1686.42,678.12,1008.3,270243.51,30 Year,0.03
156,270243.51,1686.42,675.6,1010.82,269232.69,30 Year,0.03
157,269232.69,1686.42,673.08,1013.34,268219.35,30 Year,0.03
158,268219.35,1686.42,670.54,1015.88,267203.47,30 Year,0.03
159,267203.47,1686.42,668.0,1018.42,266185.05,30 Year,0.03
160,266185.05,1686.42,665.46,1020.96,265164.09,30 Year,0.03
161,265164.09,1686.42,662.91,1023.51,264140.58,30 Year,0.03
162,264140.58,1686.42,660.35,1026.07,263114.51,30 Year,0.03
163,263114.51,1686.42,657.78,1028.64,262085.87,30 Year,0.03
164,262085.87,1686.42,655.21,1031.21,261054.66,30 Year,0.03
165,261054.66,1686.42,652.63,1033.79,260020.87,30 Year,0.03
166,260020.87,1686.42,650.05,1036.37,258984.5,30 Year,0.03
167,258984.5,1686.42,647.46,1038.96,257945.54,30 Year,0.03
168,257945.54,1686.42,644.86,1041.56,256903.98,30 Year,0.03
169,256903.98,1686.42,642.25,1044.17,255859.81,30 Year,0.03
170,255859.81,1686.42,639.64,1046.78,254813.03,30 Year,0.03
171,254813.03,1686.42,637.03,1049.39,253763.64,30 Year,0.03
172,253763.64,1686.42,634.4,1052.02,252711.62,30 Year,0.03
173,252711.62,1686.42,631.77,1054.65,251656.97,30 Year,0.03
174,251656.97,1686.42,629.14,1057.28,250599.69,30 Year,0.03
175,250599.69,1686.42,626.49,1059.93,249539.76,30 Year,0.03
176,249539.76,1686.42,623.84,1062.58,248477.18,30 Year,0.03
177,248477.18,1686.42,621.19,1065.23,247411.95,30 Year,0.03
178,247411.95,1686.42,618.52,1067.9,246344.05,30 Year,0.03
179,246344.05,1686.42,615.86,1070.56,245273.49,30 Year,0.03
180,245273.49,1686.42,613.18,1073.24,244200.25,30 Year,0.03
181,244200.25,1686.42,610.5,1075.92,243124.33,30 Year,0.03
182,243124.33,1686.42,607.81,1078.61,242045.72,30 Year,0.03
183,242045.72,1686.42,605.11,1081.31,240964.41,30 Year,0.03
184,240964.41,1686.42,602.41,1084.01,239880.4,30 Year,0.03
185,239880.4,1686.42,599.7,1086.72,238793.68,30 Year,0.03
186,238793.68,1686.42,596.98,1089.44,237704.24,30 Year,0.03
187,237704.24,1686.42,594.26,1092.16,236612.08,30 Year,0.03
188,236612.08,1686.42,591.53,1094.89,235517.19,30 Year,0.03
189,235517.19,1686.42,588.79,1097.63,234419.56,30 Year,0.03
190,234419.56,1686.42,586.04,1100.38,233319.18,30 Year,0.03
191,233319.18,1686.42,583.29,1103.13,232216.05,30 Year,0.03
192,232216.05,1686.42,580.54,1105.88,231110.17,30 Year,0.03
193,231110.17,1686.42,577.77,1108.65,230001.52,30 Year,0.03
194,230001.52,1686.42,575.0,1111.42,228890.1,30 Year,0.03
195,228890.1,1686.42,572.22,1114.2,227775.9,30 Year,0.03
196,227775.9,1686.42,569.43,1116.99,226658.91,30 Year,0.03
197,226658.91,1686.42,566.64,1119.78,225539.13,30 Year,0.03
198,225539.13,1686.42,563.84,1122.58,224416.55,30 Year,0.03
199,224416.55,1686.42,561.04,1125.38,223291.17,30 Year,0.03
200,223291.17,1686.42,558.22,1128.2,222162.97,30 Year,0.03
201,222162.97,1686.42,555.4,1131.02,221031.95,30 Year,0.03
202,221031.95,1686.42,552.57,1133.85,219898.1,30 Year,0.03
203,219898.1,1686.42,549.74,1136.68,218761.42,30 Year,0.03
204,218761.42,1686.42,546.9,1139.52,217621.9,30 Year,0.03
205,217621.9,1686.42,544.05,1142.37,216479.53,30 Year,0.03
206,216479.53,1686.42,541.19,1145.23,215334.3,30 Year,0.03
207,215334.3,1686.42,538.33,1148.09,214186.21,30 Year,0.03
208,214186.21,1686.42,535.46,1150.96,213035.25,30 Year,0.03
209,213035.25,1686.42,532.58,1153.84,211881.41,30 Year,0.03
210,211881.41,1686.42,529.7,1156.72,210724.69,30 Year,0.03
211,210724.69,1686.42,526.81,1159.61,209565.08,30 Year,0.03
212,209565.08,1686.42,523.91,1162.51,208402.57,30 Year,0.03
213,208402.57,1686.42,521.0,1165.42,207237.15,30 Year,0.03
214,207237.15,1686.42,518.09,1168.33,206068.82,30 Year,0.03
215,206068.82,1686.42,515.17,1171.25,204897.57,30 Year,0.03
216,204897.57,1686.42,512.24,1174.18,203723.39,30 Year,0.03
217,203723.39,1686.42,509.3,1177.12,202546.27,30 Year,0.03
218,202546.27,1686.42,506.36,1180.06,201366.21,30 Year,0.03
219,201366.21,1686.42,503.41,1183.01,200183.2,30 Year,0.03
220,200183.2,1686.42,500.45,1185.97,198997.23,30 Year,0.03
221,198997.23,1686.42,497.49,1188.93,197808.3,30 Year,0.03
222,197808.3,1686.42,494.52,1191.9,196616.4,30 Year,0.03
223,196616.4,1686.42,491.54,1194.88,195421.52,30 Year,0.03
224,195421.52,1686.42,488.55,1197.87,194223.65,30 Year,0.03
225,194223.65,1686.42,485.55,1200.87,193022.78,30 Year,0.03
226,193022.78,1686.42,482.55,1203.87,191818.91,30 Year,0.03
227,191818.91,1686.42,479.54,1206.88,190612.03,30 Year,0.03
228,190612.03,1686.42,476.53,1209.89,189402.14,30 Year,0.03
229,189402.14,1686.42,473.5,1212.92,188189.22,30 Year,0.03
230,188189.22,1686.42,470.47,1215.95,186973.27,30 Year,0.03
231,186973.27,1686.42,467.43,1218.99,185754.28,30 Year,0.03
232,185754.28,1686.42,464.38,1222.04,184532.24,30 Year,0.03
233,184532.24,1686.42,461.33,1225.09,183307.15,30 Year,0.03
234,183307.15,1686.42,458.26,1228.16,182078.99,30 Year,0.03
235,182078.99,1686.42,455.19,1231.23,180847.76,30 Year,0.03
236,180847.76,1686.42,452.11,1234.31,179613.45,30 Year,0.03
237,179613.45,1686.42,449.03,1237.39,178376.06,30 Year,0.03
238,178376.06,1686.42,445.94,1240.48,177135.58,30 Year,0.03
239,177135.58,1686.42,442.83,1243.59,175891.99,30 Year,0.03
240,175891.99,1686.42,439.72,1246.7,174645.29,30 Year,0.03
241,174645.29,1686.42,436.61,1249.81,173395.48,30 Year,0.03
242,173395.48,1686.42,433.48,1252.94,172142.54,30 Year,0.03
243,172142.54,1686.42,430.35,1256.07,170886.47,30 Year,0.03
244,170886.47,1686.42,427.21,1259.21,169627.26,30 Year,0.03
245,169627.26,1686.42,424.06,1262.36,168364.9,30 Year,0.03
246,168364.9,1686.42,420.91,1265.51,167099.39,30 Year,0.03
247,167099.39,1686.42,417.74,1268.68,165830.71,30 Year,0.03
248,165830.71,1686.42,414.57,1271.85,164558.86,30 Year,0.03
249,164558.86,1686.42,411.39,1275.03,163283.83,30 Year,0.03
250,163283.83,1686.42,408.2,1278.22,162005.61,30 Year,0.03
251,162005.61,1686.42,405.01,1281.41,160724.2,30 Year,0.03
252,160724.2,1686.42,401.81,1284.61,159439.59,30 Year,0.03
253,159439.59,1686.42,398.59,1287.83,158151.76,30 Year,0.03
254,158151.76,1686.42,395.37,1291.05,156860.71,30 Year,0.03
255,156860.71,1686.42,392.15,1294.27,155566.44,30 Year,0.03
256,155566.44,1686.42,388.91,1297.51,154268.93,30 Year,0.03
257,154268.93,1686.42,385.67,1300.75,152968.18,30 Year,0.03
258,152968.18,1686.42,382.42,1304.0,151664.18,30 Year,0.03
259,151664.18,1686.42,379.16,1307.26,150356.92,30 Year,0.03
260,150356.92,1686.42,375.89,1310.53,149046.39,30 Year,0.03
261,149046.39,1686.42,372.61,1313.81,147732.58,30 Year,0.03
262,147732.58,1686.42,369.33,1317.09,146415.49,30 Year,0.03
263,146415.49,1686.42,366.03,1320.39,145095.1,30 Year,0.03
264,145095.1,1686.42,362.73,1323.69,143771.41,30 Year,0.03
265,143771.41,1686.42,359.42,1327.0,142444.41,30 Year,0.03
266,142444.41,1686.42,356.11,1330.31,141114.1,30 Year,0.03
267,141114.1,1686.42,352.78,1333.64,139780.46,30 Year,0.03
268,139780.46,1686.42,349.45,1336.97,138443.49,30 Year,0.03
269,138443.49,1686.42,346.1,1340.32,137103.17,30 Year,0.03
270,137103.17,1686.42,342.75,1343.67,135759.5,30 Year,0.03
271,135759.5,1686.42,339.39,1347.03,134412.47,30 Year,0.03
272,134412.47,1686.42,336.03,1350.39,133062.08,30 Year,0.03
273,133062.08,1686.42,332.65,1353.77,131708.31,30 Year,0.03
274,131708.31,1686.42,329.27,1357.15,130351.16,30 Year,0.03
275,130351.16,1686.42,325.87,1360.55,128990.61,30 Year,0.03
276,128990.61,1686.42,322.47,1363.95,127626.66,30 Year,0.03
277,127626.66,1686.42,319.06,1367.36,126259.3,30 Year,0.03
278,126259.3,1686.42,315.64,1370.78,124888.52,30 Year,0.03
279,124888.52,1686.42,312.22,1374.2,123514.32,30 Year,0.03
280,123514.32,1686.42,308.78,1377.64,122136.68,30 Year,0.03
281,122136.68,1686.42,305.34,1381.08,120755.6,30 Year,0.03
282,120755.6,1686.42,301.88,1384.54,119371.06,30 Year,0.03
283,119371.06,1686.42,298.42,1388.0,117983.06,30 Year,0.03
284,117983.06,1686.42,294.95,1391.47,116591.59,30 Year,0.03
285,116591.59,1686.42,291.47,1394.95,115196.64,30 Year,0.03
286,115196.64,1686.42,287.99,1398.43,113798.21,30 Year,0.03
287,113798.21,1686.42,284.49,1401.93,112396.28,30 Year,0.03
288,112396.28,1686.42,280.99,1405.43,110990.85,30 Year,0.03
289,110990.85,1686.42,277.47,1408.95,109581.9,30 Year,0.03
290,109581.9,1686.42,273.95,1412.47,108169.43,30 Year,0.03
291,108169.43,1686.42,270.42,1416.0,106753.43,30 Year,0.03
292,106753.43,1686.42,266.88,1419.54,105333.89,30 Year,0.03
293,105333.89,1686.42,263.33,1423.09,103910.8,30 Year,0.03
294,103910.8,1686.42,259.77,1426.65,102484.15,30 Year,0.03
295,102484.15,1686.42,256.21,1430.21,101053.94,30 Year,0.03
296,101053.94,1686.42,252.63,1433.79,99620.15,30 Year,0.03
297,99620.15,1686.42,249.05,1437.37,98182.78,30 Year,0.03
298,98182.78,1686.42,245.45,1440.97,96741.81,30 Year,0.03
299,96741.81,1686.42,241.85,1444.57,95297.24,30 Year,0.03
300,95297.24,1686.42,238.24,1448.18,93849.06,30 Year,0.03
301,93849.06,1686.42,234.62,1451.8,92397.26,30 Year,0.03
302,92397.26,1686.42,230.99,1455.43,90941.83,30 Year,0.03
303,90941.83,1686.42,227.35,1459.07,89482.76,30 Year,0.03
304,89482.76,1686.42,223.7,1462.72,88020.04,30 Year,0.03
305,88020.04,1686.42,220.05,1466.37,86553.67,30 Year,0.03
306,86553.67,1686.42,216.38,1470.04,85083.63,30 Year,0.03
307,85083.63,1686.42,212.7,1473.72,83609.91,30 Year,0.03
308,83609.91,1686.42,209.02,1477.4,82132.51,30 Year,0.03
309,82132.51,1686.42,205.33,1481.09,80651.42,30 Year,0.03
310,80651.42,1686.42,201.62,1484.8,79166.62,30 Year,0.03
311,79166.62,1686.42,197.91,1488.51,77678.11,30 Year,0.03
312,77678.11,1686.42,194.19,1492.23,76185.88,30 Year,0.03
313,76185.88,1686.42,190.46,1495.96,74689.92,30 Year,0.03
314,74689.92,1686.42,186.72,1499.7,73190.22,30 Year,0.03
315,73190.22,1686.42,182.97,1503.45,71686.77,30 Year,0.03
316,71686.77,1686.42,179.21,1507.21,70179.56,30 Year,0.03
317,70179.56,1686.42,175.44,1510.98,68668.58,30 Year,0.03
318,68668.58,1686.42,171.67,1514.75,67153.83,30 Year,0.03
319,67153.83,1686.42,167.88,1518.54,65635.29,30 Year,0.03
320,65635.29,1686.42,164.08,1522.34,64112.95,30 Year,0.03
321,64112.95,1686.42,160.28,1526.14,62586.81,30 Year,0.03
322,62586.81,1686.42,156.46,1529.96,61056.85,30 Year,0.03
323,61056.85,1686.42,152.64,1533.78,59523.07,30 Year,0.03
324,59523.07,1686.42,148.8,1537.62,57985.45,30 Year,0.03
325,57985.45,1686.42,144.96,1541.46,56443.99,30 Year,0.03
326,56443.99,1686.42,141.1,1545.32,54898.67,30 Year,0.03
327,54898.67,1686.42,137.24,1549.18,53349.49,30 Year,0.03
328,53349.49,1686.42,133.37,1553.05,51796.44,30 Year,0.03
329,51796.44,1686.42,129.49,1556.93,50239.51,30 Year,0.03
330,50239.51,1686.42,125.59,1560.83,48678.68,30 Year,0.03
331,48678.68,1686.42,121.69,1564.73,47113.95,30 Year,0.03
332,47113.95,1686.42,117.78,1568.64,45545.31,30 Year,0.03
333,45545.31,1686.42,113.86,1572.56,43972.75,30 Year,0.03
334,43972.75,1686.42,109.93,1576.49,42396.26,30 Year,0.03
335,42396.26,1686.42,105.99,1580.43,40815.83,30 Year,0.03
336,40815.83,1686.42,102.03,1584.39,39231.44,30 Year,0.03
337,39231.44,1686.42,98.07,1588.35,37643.09,30 Year,0.03
338,37643.09,1686.42,94.1,1592.32,36050.77,30 Year,0.03
339,36050.77,1686.42,90.12,1596.3,34454.47,30 Year,0.03
340,34454.47,1686.42,86.13,1600.29,32854.18,30 Year,0.03
341,32854.18,1686.42,82.13,1604.29,31249.89,30 Year,0.03
342,31249.89,1686.42,78.12,1608.3,29641.59,30 Year,0.03
343,29641.59,1686.42,74.1,1612.32,28029.27,30 Year,0.03
344,28029.27,1686.42,70.07,1616.35,26412.92,30 Year,0.03
345,26412.92,1686.42,66.03,1620.39,24792.53,30 Year,0.03
346,24792.53,1686.42,61.98,1624.44,23168.09,30 Year,0.03
347,23168.09,1686.42,57.92,1628.5,21539.59,30 Year,0.03
348,21539.59,1686.42,53.84,1632.58,19907.01,30 Year,0.03
349,19907.01,1686.42,49.76,1636.66,18270.35,30 Year,0.03
350,18270.35,1686.42,45.67,1640.75,16629.6,30 Year,0.03
351,16629.6,1686.42,41.57,1644.85,14984.75,30 Year,0.03
352,14984.75,1686.42,37.46,1648.96,13335.79,30 Year,0.03
353,13335.79,1686.42,33.33,1653.09,11682.7,30 Year,0.03
354,11682.7,1686.42,29.2,1657.22,10025.48,30 Year,0.03
355,10025.48,1686.42,25.06,1661.36,8364.12,30 Year,0.03
356,8364.12,1686.42,20.91,1665.51,6698.61,30 Year,0.03
357,6698.61,1686.42,16.74,1669.68,5028.93,30 Year,0.03
358,5028.93,1686.42,12.57,1673.85,3355.08,30 Year,0.03
359,3355.08,1686.42,8.38,1678.04,1677.04,30 Year,0.03
360,1677.04,1686.42,4.19,1682.23,-5.19,30 Year,0.03
1,400000.0,2147.29,1666.66,480.63,399519.37,30 Year,0.05
2,399519.37,2147.29,1664.66,482.63,399036.74,30 Year,0.05
3,399036.74,2147.29,1662.65,484.64,398552.1,30 Year,0.05
4,398552.1,2147.29,1660.63,486.66,398065.44,30 Year,0.05
5,398065.44,2147.29,1658.6,488.69,397576.75,30 Year,0.05
6,397576.75,2147.29,1656.56,490.73,397086.02,30 Year,0.05
7,397086.02,2147.29,1654.52,492.77,396593.25,30 Year,0.05
8,396593.25,2147.29,1652.47,494.82,396098.43,30 Year,0.05
9,396098.43,2147.29,1650.41,496.88,395601.55,30 Year,0.05
10,395601.55,2147.29,1648.33,498.96,395102.59,30 Year,0.05
11,395102.59,2147.29,1646.26,501.03,394601.56,30 Year,0.05
12,394601.56,2147.29,1644.17,503.12,394098.44,30 Year,0.05
13,394098.44,2147.29,1642.07,505.22,393593.22,30 Year,0.05
14,393593.22,2147.29,1639.97,507.32,393085.9,30 Year,0.05
15,393085.9,2147.29,1637.85,509.44,392576.46,30 Year,0.05
16,392576.46,2147.29,1635.73,511.56,392064.9,30 Year,0.05
17,392064.9,2147.29,1633.6,513.69,391551.21,30 Year,0.05
18,391551.21,2147.29,1631.46,515.83,391035.38,30 Year,0.05
19,391035.38,2147.29,1629.31,517.98,390517.4,30 Year,0.05
20,390517.4,2147.29,1627.15,520.14,389997.26,30 Year,0.05
21,389997.26,2147.29,1624.98,522.31,389474.95,30 Year,0.05
22,389474.95,2147.29,1622.81,524.48,388950.47,30 Year,0.05
23,388950.47,2147.29,1620.62,526.67,388423.8,30 Year,0.05
24,388423.8,2147.29,1618.43,528.86,387894.94,30 Year,0.05
25,387894.94,2147.29,1616.22,531.07,387363.87,30 Year,0.05
26,387363.87,2147.29,1614.01,533.28,386830.59,30 Year,0.05
27,386830.59,2147.29,1611.79,535.5,386295.09,30 Year,0.05
28,386295.09,2147.29,1609.56,537.73,385757.36,30 Year,0.05
29,385757.36,2147.29,1607.32,539.97,385217.39,30 Year,0.05
30,385217.39,2147.29,1605.07,542.22,384675.17,30 Year,0.05
31,384675.17,2147.29,1602.81,544.48,384130.69,30 Year,0.05
32,384130.69,2147.29,1600.54,546.75,383583.94,30 Year,0.05
33,383583.94,2147.29,1598.26,549.03,383034.91,30 Year,0.05
34,383034.91,2147.29,1595.97,551.32,382483.59,30 Year,0.05
35,382483.59,2147.29,1593.68,553.61,381929.98,30 Year,0.05
36,381929.98,2147.29,1591.37,555.92,381374.06,30 Year,0.05
37,381374.06,2147.29,1589.05,558.24,380815.82,30 Year,0.05
38,380815.82,2147.29,1586.73,560.56,380255.26,30 Year,0.05
39,380255.26,2147.29,1584.39,562.9,379692.36,30 Year,0.05
40,379692.36,2147.29,1582.05,565.24,379127.12,30 Year,0.05
41,379127.12,2147.29,1579.69,567.6,378559.52,30 Year,0.05
42,378559.52,2147.29,1577.33,569.96,377989.56,30 Year,0.05
43,377989.56,2147.29,1574.95,572.34,377417.22,30 Year,0.05
44,377417.22,2147.29,1572.57,574.72,376842.5,30 Year,0.05
45,376842.5,2147.29,1570.17,577.12,376265.38,30 Year,0.05
46,376265.38,2147.29,1567.77,579.52,375685.86,30 Year,0.05
47,375685.86,2147.29,1565.35,581.94,375103.92,30 Year,0.05
48,375103.92,2147.29,1562.93,584.36,374519.56,30 Year,0.05
49,374519.56,2147.29,1560.49,586.8,373932.76,30 Year,0.05
50,373932.76,2147.29,1558.05,589.24,373343.52,30 Year,0.05
51,373343.52,2147.29,1555.59,591.7,372751.82,30 Year,0.05
52,372751.82,2147.29,1553.13,594.16,372157.66,30 Year,0.05
53,372157.66,2147.29,1550.65,596.64,371561.02,30 Year,0.05
54,371561.02,2147.29,1548.17,599.12,370961.9,30 Year,0.05
55,370961.9,2147.29,1545.67,601.62,370360.28,30 Year,0.05
56,370360.28,2147.29,1543.16,604.13,369756.15,30 Year,0.05
57,369756.15,2147.29,1540.65,606.64,369149.51,30 Year,0.05
58,369149.51,2147.29,1538.12,609.17,368540.34,30 Year,0.05
59,368540.34,2147.29,1535.58,611.71,367928.63,30 Year,0.05
60,367928.63,2147.29,1533.03,614.26,367314.37,30 Year,0.05
61,367314.37,2147.29,1530.47,616.82,366697.55,30 Year,0.05
62,366697.55,2147.29,1527.9,619.39,366078.16,30 Year,0.05
63,366078.16,2147.29,1525.32,621.97,365456.19,30 Year,0.05
64,365456.19,2147.29,1522.73,624.56,364831.63,30 Year,0.05
65,364831.63,2147.29,1520.13,627.16,364204.47,30 Year,0.05
66,364204.47,2147.29,1517.51,629.78,363574.69,30 Year,0.05
67,363574.69,2147.29,1514.89,632.4,362942.29,30 Year,0.05
68,362942.29,2147.29,1512.25,635.04,362307.25,30 Year,0.05
69,362307.25,2147.29,1509.61,637.68,361669.57,30 Year,0.05
70,361669.57,2147.29,1506.95,640.34,361029.23,30 Year,0.05
71,361029.23,2147.29,1504.28,643.01,360386.22,30 Year,0.05
72,360386.22,2147.29,1501.6,645.69,359740.53,30 Year,0.05
73,359740.53,2147.29,1498.91,648.38,359092.15,30 Year,0.05
74,359092.15,2147.29,1496.21,651.08,358441.07,30 Year,0.05
75,358441.07,2147.29,1493.5,653.79,357787.28,30 Year,0.05
76,357787.28,2147.29,1490.78,656.51,357130.77,30 Year,0.05
77,357130.77,2147.29,1488.04,659.25,356471.52,30 Year,0.05
78,356471.52,2147.29,1485.29,662.0,355809.52,30 Year,0.05
79,355809.52,2147.29,1482.53,664.76,355144.76,30 Year,0.05
80,355144.76,2147.29,1479.76,667.53,354477.23,30 Year,0.05
81,354477.23,2147.29,1476.98,670.31,353806.92,30 Year,0.05
82,353806.92,2147.29,1474.19,673.1,353133.82,30 Year,0.05
83,353133.82,2147.29,1471.39,675.9,352457.92,30 Year,0.05
84,352457.92,2147.29,1468.57,678.72,351779.2,30 Year,0.05
85,351779.2,2147.29,1465.74,681.55,351097.65,30 Year,0.05
86,351097.65,2147.29,1462.9,684.39,350413.26,30 Year,0.05
87,350413.26,2147.29,1460.05,687.24,349726.02,30 Year,0.05
88,349726.02,2147.29,1457.19,690.1,349035.92,30 Year,0.05
89,349035.92,2147.29,1454.31,692.98,348342.94,30 Year,0.05
90,348342.94,2147.29,1451.42,695.87,347647.07,30 Year,0.05
91,347647.07,2147.29,1448.52,698.77,346948.3,30 Year,0.05
92,346948.3,2147.29,1445.61,701.68,346246.62,30 Year,0.05
93,346246.62,2147.29,1442.69,704.6,345542.02,30 Year,0.05
94,345542.02,2147.29,1439.75,707.54,344834.48,30 Year,0.05
95,344834.48,2147.29,1436.81,710.48,344124.0,30 Year,0.05
96,344124.0,2147.29,1433.85,713.44,343410.56,30 Year,0.05
97,343410.56,2147.29,1430.87,716.42,342694.14,30 Year,0.05
98,342694.14,2147.29,1427.89,719.4,341974.74,30 Year,0.05
99,341974.74,2147.29,1424.89,722.4,341252.34,30 Year,0.05
100,341252.34,2147.29,1421.88,725.41,340526.93,30 Year,0.05
101,340526.93,2147.29,1418.86,728.43,339798.5,30 Year,0.05
102,339798.5,2147.29,1415.82,731.47,339067.03,30 Year,0.05
103,339067.03,2147.29,1412.77,734.52,338332.51,30 Year,0.05
104,338332.51,2147.29,1409.71,737.58,337594.93,30 Year,0.05
105,337594.93,2147.29,1406.64,740.65,336854.28,30 Year,0.05
106,336854.28,2147.29,1403.55,743.74,336110.54,30 Year,0.05
107,336110.54,2147.29,1400.46,746.83,335363.71,30 Year,0.05
108,335363.71,2147.29,1397.34,749.95,334613.76,30 Year,0.05
109,334613.76,2147.29,1394.22,753.07,333860.69,30 Year,0.05
110,333860.69,2147.29,1391.08,756.21,333104.48,30 Year,0.05
111,333104.48,2147.29,1387.93,759.36,332345.12,30 Year,0.05
112,332345.12,2147.29,1384.77,762.52,331582.6,30 Year,0.05
113,331582.6,2147.29,1381.59,765.7,330816.9,30 Year,0.05
114,330816.9,2147.29,1378.4,768.89,330048.01,30 Year,0.05
115,330048.01,2147.29,1375.2,772.09,329275.92,30 Year,0.05
116,329275.92,2147.29,1371.98,775.31,328500.61,30 Year,0.05
117,328500.61,2147.29,1368.75,778.54,327722.07,30 Year,0.05
118,327722.07,2147.29,1365.5,781.79,326940.28,30 Year,0.05
119,326940.28,2147.29,1362.25,785.04,326155.24,30 Year,0.05
120,326155.24,2147.29,1358.98,788.31,325366.93,30 Year,0.05
121,325366.93,2147.29,1355.69,791.6,324575.33,30 Year,0.05
122,324575.33,2147.29,1352.39,794.9,323780.43,30 Year,0.05
123,323780.43,2147.29,1349.08,798.21,322982.22,30 Year,0.05
124,322982.22,2147.29,1345.75,801.54,322180.68,30 Year,0.05
125,322180.68,2147.29,1342.41,804.88,321375.8,30 Year,0.05
126,321375.8,2147.29,1339.06,808.23,320567.57,30 Year,0.05
127,320567.57,2147.29,1335.69,811.6,319755.97,30 Year,0.05
128,319755.97,2147.29,1332.31,814.98,318940.99,30 Year,0.05
129,318940.99,2147.29,1328.92,818.37,318122.62,30 Year,0.05
130,318122.62,2147.29,1325.51,821.78,317300.84,30 Year,0.05
131,317300.84,2147.29,1322.08,825.21,316475.63,30 Year,0.05
132,316475.63,2147.29,1318.64,828.65,315646.98,30 Year,0.05
133,315646.98,2147.29,1315.19,832.1,314814.88,30 Year,0.05
134,314814.88,2147.29,1311.72,835.57,313979.31,30 Year,0.05
135,313979.31,2147.29,1308.24,839.05,313140.26,30 Year,0.05
136,313140.26,2147.29,1304.75,842.54,312297.72,30 Year,0.05
137,312297.72,2147.29,1301.24,846.05,311451.67,30 Year,0.05
138,311451.67,2147.29,1297.71,849.58,310602.09,30 Year,0.05
139,310602.09,2147.29,1294.17,853.12,309748.97,30 Year,0.05
140,309748.97,2147.29,1290.62,856.67,308892.3,30 Year,0.05
141,308892.3,2147.29,1287.05,860.24,308032.06,30 Year,0.05
142,308032.06,2147.29,1283.46,863.83,307168.23,30 Year,0.05
143,307168.23,2147.29,1279.86,867.43,306300.8,30 Year,0.05
144,306300.8,2147.29,1276.25,871.04,305429.76,30 Year,0.05
145,305429.76,2147.29,1272.62,874.67,304555.09,30 Year,0.05
146,304555.09,2147.29,1268.97,878.32,303676.77,30 Year,0.05
147,303676.77,2147.29,1265.31,881.98,302794.79,30 Year,0.05
148,302794.79,2147.29,1261.64,885.65,301909.14,30 Year,0.05
149,301909.14,2147.29,1257.95,889.34,301019.8,30 Year,0.05
150,301019.8,2147.29,1254.24,893.05,300126.75,30 Year,0.05
151,300126.75,2147.29,1250.52,896.77,299229.98,30 Year,0.05
152,299229.98,2147.29,1246.79,900.5,298329.48,30 Year,0.05
153,298329.48,2147.29,1243.03,904.26,297425.22,30 Year,0.05
154,297425.22,2147.29,1239.27,908.02,296517.2,30 Year,0.05
155,296517.2,2147.29,1235.48,911.81,295605.39,30 Year,0.05
156,295605.39,2147.29,1231.68,915.61,294689.78,30 Year,0.05
157,294689.78,2147.29,1227.87,919.42,293770.36,30 Year,0.05
158,293770.36,2147.29,1224.04,923.25,292847.11,30 Year,0.05
159,292847.11,2147.29,1220.19,927.1,291920.01,30 Year,0.05
160,291920.01,2147.29,1216.33,930.96,290989.05,30 Year,0.05
161,290989.05,2147.29,1212.45,934.84,290054.21,30 Year,0.05
162,290054.21,2147.29,1208.55,938.74,289115.47,30 Year,0.05
163,289115.47,2147.29,1204.64,942.65,288172.82,30 Year,0.05
164,288172.82,2147.29,1200.72,946.57,287226.25,30 Year,0.05
165,287226.25,2147.29,1196.77,950.52,286275.73,30 Year,0.05
166,286275.73,2147.29,1192.81,954.48,285321.25,30 Year,0.05
167,285321.25,2147.29,1188.83,958.46,284362.79,30 Year,0.05
168,284362.79,2147.29,1184.84,962.45,283400.34,30 Year,0.05
169,283400.34,2147.29,1180.83,966.46,282433.88,30 Year,0.05
170,282433.88,2147.29,1176.8,970.49,281463.39,30 Year,0.05
171,281463.39,2147.29,1172.76,974.53,280488.86,30 Year,0.05
172,280488.86,2147.29,1168.7,978.59,279510.27,30 Year,0.05
173,279510.27,2147.29,1164.62,982.67,278527.6,30 Year,0.05
174,278527.6,2147.29,1160.53,986.76,277540.84,30 Year,0.05
175,277540.84,2147.29,1156.42,990.87,276549.97,30 Year,0.05
176,276549.97,2147.29,1152.29,995.0,275554.97,30 Year,0.05
177,275554.97,2147.29,1148.14,999.15,274555.82,30 Year,0.05
178,274555.82,2147.29,1143.98,1003.31,273552.51,30 Year,0.05
179,273552.51,2147.29,1139.8,1007.49,272545.02,30 Year,0.05
180,272545.02,2147.29,1135.6,1011.69,271533.33,30 Year,0.05
181,271533.33,2147.29,1131.38,1015.91,270517.42,30 Year,0.05
182,270517.42,2147.29,1127.15,1020.14,269497.28,30 Year,0.05
183,269497.28,2147.29,1122.9,1024.39,268472.89,30 Year,0.05
184,268472.89,2147.29,1118.63,1028.66,267444.23,30 Year,0.05
185,267444.23,2147.29,1114.35,1032.94,266411.29,30 Year,0.05
186,266411.29,2147.29,1110.04,1037.25,265374.04,30 Year,0.05
187,265374.04,2147.29,1105.72,1041.57,264332.47,30 Year,0.05
188,264332.47,2147.29,1101.38,1045.91,263286.56,30 Year,0.05
189,263286.56,2147.29,1097.02,1050.27,262236.29,30 Year,0.05
190,262236.29,2147.29,1092.65,1054.64,261181.65,30 Year,0.05
191,261181.65,2147.29,1088.25,1059.04,260122.61,30 Year,0.05
192,260122.61,2147.29,1083.84,1063.45,259059.16,30 Year,0.05
193,259059.16,2147.29,1079.41,1067.88,257991.28,30 Year,0.05
194,257991.28,2147.29,1074.96,1072.33,256918.95,30 Year,0.05
195,256918.95,2147.29,1070.49,1076.8,255842.15,30 Year,0.05
196,255842.15,2147.29,1066.0,1081.29,254760.86,30 Year,0.05
197,254760.86,2147.29,1061.5,1085.79,253675.07,30 Year,0.05
198,253675.07,2147.29,1056.97,1090.32,252584.75,30 Year,0.05
199,252584.75,2147.29,1052.43,1094.86,251489.89,30 Year,0.05
200,251489.89,2147.29,1047.87,1099.42,250390.47,30 Year,0.05
201,250390.47,2147.29,1043.29,1104.0,249286.47,30 Year,0.05
202,249286.47,2147.29,1038.69,1108.6,248177.87,30 Year,0.05
203,248177.87,2147.29,1034.07,1113.22,247064.65,30 Year,0.05
204,247064.65,2147.29,1029.43,1117.86,245946.79,30 Year,0.05
205,245946.79,2147.29,1024.77,1122.52,244824.27,30 Year,0.05
206,244824.27,2147.29,1020.1,1127.19,243697.08,30 Year,0.05
207,243697.08,2147.29,1015.4,1131.89,242565.19,30 Year,0.05
208,242565.19,2147.29,1010.68,1136.61,241428.58,30 Year,0.05
209,241428.58,2147.29,1005.95,1141.34,240287.24,30 Year,0.05
210,240287.24,2147.29,1001.19,1146.1,239141.14,30 Year,0.05
211,239141.14,2147.29,996.42,1150.87,237990.27,30 Year,0.05
212,237990.27,2147.29,991.62,1155.67,236834.6,30 Year,0.05
213,236834.6,2147.29,986.81,1160.48,235674.12,30 Year,0.05
214,235674.12,2147.29,981.97,1165.32,234508.8,30 Year,0.05
215,234508.8,2147.29,977.11,1170.18,233338.62,30 Year,0.05
216,233338.62,2147.29,972.24,1175.05,232163.57,30 Year,0.05
217,232163.57,2147.29,967.34,1179.95,230983.62,30 Year,0.05
218,230983.62,2147.29,962.43,1184.86,229798.76,30 Year,0.05
219,229798.76,2147.29,957.49,1189.8,228608.96,30 Year,0.05
220,228608.96,2147.29,952.53,1194.76,227414.2,30 Year,0.05
221,227414.2,2147.29,947.55,1199.74,226214.46,30 Year,0.05
222,226214.46,2147.29,942.56,1204.73,225009.73,30 Year,0.05
223,225009.73,2147.29,937.54,1209.75,223799.98,30 Year,0.05
224,223799.98,2147.29,932.49,1214.8,222585.18,30 Year,0.05
225,222585.18,2147.29,927.43,1219.86,221365.32,30 Year,0.05
226,221365.32,2147.29,922.35,1224.94,220140.38,30 Year,0.05
227,220140.38,2147.29,917.25,1230.04,218910.34,30 Year,0.05
228,218910.34,2147.29,912.12,1235.17,217675.17,30 Year,0.05
229,217675.17,2147.29,906.97,1240.32,216434.85,30 Year,0.05
230,216434.85,2147.29,901.81,1245.48,215189.37,30 Year,0.05
231,215189.37,2147.29,896.62,1250.67,213938.7,30 Year,0.05
232,213938.7,2147.29,891.41,1255.88,212682.82,30 Year,0.05
233,212682.82,2147.29,886.17,1261.12,211421.7,30 Year,0.05
234,211421.7,2147.29,880.92,1266.37,210155.33,30 Year,0.05
235,210155.33,2147.29,875.64,1271.65,208883.68,30 Year,0.05
236,208883.68,2147.29,870.34,1276.95,207606.73,30 Year,0.05
237,207606.73,2147.29,865.02,1282.27,206324.46,30 Year,0.05
238,206324.46,2147.29,859.68,1287.61,205036.85,30 Year,0.05
239,205036.85,2147.29,854.32,1292.97,203743.88,30 Year,0.05
240,203743.88,2147.29,848.93,1298.36,202445.52,30 Year,0.05
241,202445.52,2147.29,843.52,1303.77,201141.75,30 Year,0.05
242,201141.75,2147.29,838.09,1309.2,199832.55,30 Year,0.05
243,199832.55,2147.29,832.63,1314.66,198517.89,30 Year,0.05
244,198517.89,2147.29,827.15,1320.14,197197.75,30 Year,0.05
245,197197.75,2147.29,821.65,1325.64,195872.11,30 Year,0.05
246,195872.11,2147.29,816.13,1331.16,194540.95,30 Year,0.05
247,194540.95,2147.29,810.58,1336.71,193204.24,30 Year,0.05
248,193204.24,2147.29,805.01,1342.28,191861.96,30 Year,0.05
249,191861.96,2147.29,799.42,1347.87,190514.09,30 Year,0.05
250,190514.09,2147.29,793.8,1353.49,189160.6,30 Year,0.05
251,189160.6,2147.29,788.16,1359.13,187801.47,30 Year,0.05
252,187801.47,2147.29,782.5,1364.79,186436.68,30 Year,0.05
253,186436.68,2147.29,776.81,1370.48,185066.2,30 Year,0.05
254,185066.2,2147.29,771.1,1376.19,183690.01,30 Year,0.05
255,183690.01,2147.29,765.37,1381.92,182308.09,30 Year,0.05
256,182308.09,2147.29,759.61,1387.68,180920.41,30 Year,0.05
257,180920.41,2147.29,753.83,1393.46,179526.95,30 Year,0.05
258,179526.95,2147.29,748.02,1399.27,178127.68,30 Year,0.05
259,178127.68,2147.29,742.19,1405.1,176722.58,30 Year,0.05
260,176722.58,2147.29,736.34,1410.95,175311.63,30 Year,0.05
261,175311.63,2147.29,730.46,1416.83,173894.8,30 Year,0.05
262,173894.8,2147.29,724.56,1422.73,172472.07,30 Year,0.05
263,172472.07,2147.29,718.63,1428.66,171043.41,30 Year,0.05
264,171043.41,2147.29,712.68,1434.61,169608.8,30 Year,0.05
265,169608.8,2147.29,706.7,1440.59,168168.21,30 Year,0.05
266,168168.21,2147.29,700.7,1446.59,166721.62,30 Year,0.05
267,166721.62,2147.29,694.67,1452.62,165269.0,30 Year,0.05
268,165269.0,2147.29,688.62,1458.67,163810.33,30 Year,0.05
269,163810.33,2147.29,682.54,1464.75,162345.58,30 Year,0.05
270,162345.58,2147.29,676.43,1470.86,160874.72,30 Year,0.05
271,160874.72,2147.29,670.31,1476.98,159397.74,30 Year,0.05
272,159397.74,2147.29,664.15,1483.14,157914.6,30 Year,0.05
273,157914.6,2147.29,657.97,1489.32,156425.28,30 Year,0.05
274,156425.28,2147.29,651.77,1495.52,154929.76,30 Year,0.05
275,154929.76,2147.29,645.54,1501.75,153428.01,30 Year,0.05
276,153428.01,2147.29,639.28,1508.01,151920.0,30 Year,0.05
277,151920.0,2147.29,633.0,1514.29,150405.71,30 Year,0.05
278,150405.71,2147.29,626.69,1520.6,148885.11,30 Year,0.05
279,148885.11,2147.29,620.35,1526.94,147358.17,30 Year,0.05
280,147358.17,2147.29,613.99,1533.3,145824.87,30 Year,0.05
281,145824.87,2147.29,607.6,1539.69,144285.18,30 Year,0.05
282,144285.18,2147.29,601.18,1546.11,142739.07,30 Year,0.05
283,142739.07,2147.29,594.74,1552.55,141186.52,30 Year,0.05
284,141186.52,2147.29,588.27,1559.02,139627.5,30 Year,0.05
285,139627.5,2147.29,581.78,1565.51,138061.99,30 Year,0.05
286,138061.99,2147.29,575.25,1572.04,136489.95,30 Year,0.05
287,136489.95,2147.29,568.7,1578.59,134911.36,30 Year,0.05
288,134911.36,2147.29,562.13,1585.16,133326.2,30 Year,0.05
289,133326.2,2147.29,555.52,1591.77,131734.43,30 Year,0.05
290,131734.43,2147.29,548.89,1598.4,130136.03,30 Year,0.05
291,130136.03,2147.29,542.23,1605.06,128530.97,30 Year,0.05
292,128530.97,2147.29,535.54,1611.75,126919.22,30 Year,0.05
293,126919.22,2147.29,528.83,1618.46,125300.76,30 Year,0.05
294,125300.76,2147.29,522.08,1625.21,123675.55,30 Year,0.05
295,123675.55,2147.29,515.31,1631.98,122043.57,30 Year,0.05
296,122043.57,2147.29,508.51,1638.78,120404.79,30 Year,0.05
297,120404.79,2147.29,501.68,1645.61,118759.18,30 Year,0.05
298,118759.18,2147.29,494.82,1652.47,117106.71,30 Year,0.05
299,117106.71,2147.29,487.94,1659.35,115447.36,30 Year,0.05
300,115447.36,2147.29,481.03,1666.26,113781.1,30 Year,0.05
301,113781.1,2147.29,474.08,1673.21,112107.89,30 Year,0.05
302,112107.89,2147.29,467.11,1680.18,110427.71,30 Year,0.05
303,110427.71,2147.29,460.11,1687.18,108740.53,30 Year,0.05
304,108740.53,2147.29,453.08,1694.21,107046.32,30 Year,0.05
305,107046.32,2147.29,446.02,1701.27,105345.05,30 Year,0.05
306,105345.05,2147.29,438.93,1708.36,103636.69,30 Year,0.05
307,103636.69,2147.29,431.81,1715.48,101921.21,30 Year,0.05
308,101921.21,2147.29,424.67,1722.62,100198.59,30 Year,0.05
309,100198.59,2147.29,417.49,1729.8,98468.79,30 Year,0.05
310,98468.79,2147.29,410.28,1737.01,96731.78,30 Year,0.05
311,96731.78,2147.29,403.04,1744.25,94987.53,30 Year,0.05
312,94987.53,2147.29,395.78,1751.51,93236.02,30 Year,0.05
313,93236.02,2147.29,388.48,1758.81,91477.21,30 Year,0.05
314,91477.21,2147.29,381.15,1766.14,89711.07,30 Year,0.05
315,89711.07,2147.29,373.79,1773.5,87937.57,30 Year,0.05
316,87937.57,2147.29,366.4,1780.89,86156.68,30 Year,0.05
317,86156.68,2147.29,358.98,1788.31,84368.37,30 Year,0.05
318,84368.37,2147.29,351.53,1795.76,82572.61,30 Year,0.05
319,82572.61,2147.29,344.05,1803.24,80769.37,30 Year,0.05
320,80769.37,2147.29,336.53,1810.76,78958.61,30 Year,0.05
321,78958.61,2147.29,328.99,1818.3,77140.31,30 Year,0.05
322,77140.31,2147.29,321.41,1825.88,75314.43,30 Year,0.05
323,75314.43,2147.29,313.81,1833.48,73480.95,30 Year,0.05
324,73480.95,2147.29,306.17,1841.12,71639.83,30 Year,0.05
325,71639.83,2147.29,298.49,1848.8,69791.03,30 Year,0.05
326,69791.03,2147.29,290.79,1856.5,67934.53,30 Year,0.05
327,67934.53,2147.29,283.06,1864.23,66070.3,30 Year,0.05
328,66070.3,2147.29,275.29,1872.0,64198.3,30 Year,0.05
329,64198.3,2147.29,267.49,1879.8,62318.5,30 Year,0.05
330,62318.5,2147.29,259.66,1887.63,60430.87,30 Year,0.05
331,60430.87,2147.29,251.79,1895.5,58535.37,30 Year,0.05
332,58535.37,2147.29,243.89,1903.4,56631.97,30 Year,0.05
333,56631.97,2147.29,235.96,1911.33,54720.64,30 Year,0.05
334,54720.64,2147.29,228.0,1919.29,52801.35,30 Year,0.05
335,52801.35,2147.29,220.0,1927.29,50874.06,30 Year,0.05
336,50874.06,2147.29,211.97,1935.32,48938.74,30 Year,0.05
337,48938.74,2147.29,203.91,1943.38,46995.36,30 Year,0.05
338,46995.36,2147.29,195.81,1951.48,45043.88,30 Year,0.05
339,45043.88,2147.29,187.68,1959.61,43084.27,30 Year,0.05
340,43084.27,2147.29,179.51,1967.78,41116.49,30 Year,0.05
341,41116.49,2147.29,171.31,1975.98,39140.51,30 Year,0.05
342,39140.51,2147.29,163.08,1984.21,37156.3,30 Year,0.05
343,37156.3,2147.29,154.81,1992.48,35163.82,30 Year,0.05
344,35163.82,2147.29,146.51,2000.78,33163.04,30 Year,0.05
345,33163.04,2147.29,138.17,2009.12,31153.92,30 Year,0.05
346,31153.92,2147.29,129.8,2017.49,29136.43,30 Year,0.05
347,29136.43,2147.29,121.4,2025.89,27110.54,30 Year,0.05
348,27110.54,2147.29,112.96,2034.33,25076.21,30 Year,0.05
349,25076.21,2147.29,104.48,2042.81,23033.4,30 Year,0.05
350,23033.4,2147.29,95.97,2051.32,20982.08,30 Year,0.05
351,20982.08,2147.29,87.42,2059.87,18922.21,30 Year,0.05
352,18922.21,2147.29,78.84,2068.45,16853.76,30 Year,0.05
353,16853.76,2147.29,70.22,2077.07,14776.69,30 Year,0.05
354,14776.69,2147.29,61.56,2085.73,12690.96,30 Year,0.05
355,12690.96,2147.29,52.87,2094.42,10596.54,30 Year,0.05
356,10596.54,2147.29,44.15,2103.14,8493.4,30 Year,0.05
357,8493.4,2147.29,35.38,2111.91,6381.49,30 Year,0.05
358,6381.49,2147.29,26.58,2120.71,4260.78,30 Year,0.05
359,4260.78,2147.29,17.75,2129.54,2131.24,30 Year,0.05
360,2131.24,2147.29,8.88,2138.41,-7.17,30 Year,0.05
1,400000.0,2762.33,1000.0,1762.33,398237.67,15 Year,0.03
2,398237.67,2762.33,995.59,1766.74,396470.93,15 Year,0.03
3,396470.93,2762.33,991.17,1771.16,394699.77,15 Year,0.03
4,394699.77,2762.33,986.74,1775.59,392924.18,15 Year,0.03
5,392924.18,2762.33,982.31,1780.02,391144.16,15 Year,0.03
6,391144.16,2762.33,977.86,1784.47,389359.69,15 Year,0.03
7,389359.69,2762.33,973.39,1788.94,387570.75,15 Year,0.03
8,387570.75,2762.33,968.92,1793.41,385777.34,15 Year,0.03
9,385777.34,2762.33,964.44,1797.89,383979.45,15 Year,0.03
10,383979.45,2762.33,959.94,1802.39,382177.06,15 Year,0.03
11,382177.06,2762.33,955.44,1806.89,380370.17,15 Year,0.03
12,380370.17,2762.33,950.92,1811.41,378558.76,15 Year,0.03
13,378558.76,2762.33,946.39,1815.94,376742.82,15 Year,0.03
14,376742.82,2762.33,941.85,1820.48,374922.34,15 Year,0.03
15,374922.34,2762.33,937.3,1825.03,373097.31,15 Year,0.03
16,373097.31,2762.33,932.74,1829.59,371267.72,15 Year,0.03
17,371267.72,2762.33,928.16,1834.17,369433.55,15 Year,0.03
18,369433.55,2762.33,923.58,1838.75,367594.8,15 Year,0.03
19,367594.8,2762.33,918.98,1843.35,365751.45,15 Year,0.03
20,365751.45,2762.33,914.37,1847.96,363903.49,15 Year,0.03
21,363903.49,2762.33,909.75,1852.58,362050.91,15 Year,0.03
22,362050.91,2762.33,905.12,1857.21,360193.7,15 Year,0.03
23,360193.7,2762.33,900.48,1861.85,358331.85,15 Year,0.03
24,358331.85,2762.33,895.82,1866.51,356465.34,15 Year,0.03
25,356465.34,2762.33,891.16,1871.17,354594.17,15 Year,0.03
26,354594.17,2762.33,886.48,1875.85,352718.32,15 Year,0.03
27,352718.32,2762.33,881.79,1880.54,350837.78,15 Year,0.03
28,350837.78,2762.33,877.09,1885.24,348952.54,15 Year,0.03
29,348952.54,2762.33,872.38,1889.95,347062.59,15 Year,0.03
30,347062.59,2762.33,867.65,1894.68,345167.91,15 Year,0.03
31,345167.91,2762.33,862.91,1899.42,343268.49,15 Year,0.03
32,343268.49,2762.33,858.17,1904.16,341364.33,15 Year,0.03
33,341364.33,2762.33,853.41,1908.92,339455.41,15 Year,0.03
34,339455.41,2762.33,848.63,1913.7,337541.71,15 Year,0.03
35,337541.71,2762.33,843.85,1918.48,335623.23,15 Year,0.03
36,335623.23,2762.33,839.05,1923.28,333699.95,15 Year,0.03
37,333699.95,2762.33,834.24,1928.09,331771.86,15 Year,0.03
38,331771.86,2762.33,829.42,1932.91,329838.95,15 Year,0.03
39,329838.95,2762.33,824.59,1937.74,327901.21,15 Year,0.03
40,327901.21,2762.33,819.75,1942.58,325958.63,15 Year,0.03
41,325958.63,2762.33,814.89,1947.44,324011.19,15 Year,0.03
42,324011.19,2762.33,810.02,1952.31,322058.88,15 Year,0.03
43,322058.88,2762.33,805.14,1957.19,320101.69,15 Year,0.03
44,320101.69,2762.33,800.25,1962.08,318139.61,15 Year,0.03
45,318139.61,2762.33,795.34,1966.99,316172.62,15 Year,0.03
46,316172.62,2762.33,790.43,1971.9,314200.72,15 Year,0.03
47,314200.72,2762.33,785.5,1976.83,312223.89,15 Year,0.03
48,312223.89,2762.33,780.55,1981.78,310242.11,15 Year,0.03
49,310242.11,2762.33,775.6,1986.73,308255.38,15 Year,0.03
50,308255.38,2762.33,770.63,1991.7,306263.68,15 Year,0.03
51,306263.68,2762.33,765.65,1996.68,304267.0,15 Year,0.03
52,304267.0,2762.33,760.66,2001.67,302265.33,15 Year,0.03
53,302265.33,2762.33,755.66,2006.67,300258.66,15 Year,0.03
54,300258.66,2762.33,750.64,2011.69,298246.97,15 Year,0.03
55,298246.97,2762.33,745.61,2016.72,296230.25,15 Year,0.03
56,296230.25,2762.33,740.57,2021.76,294208.49,15 Year,0.03
57,294208.49,2762.33,735.52,2026.81,292181.68,15 Year,0.03
58,292181.68,2762.33,730.45,2031.88,290149.8,15 Year,0.03
59,290149.8,2762.33,725.37,2036.96,288112.84,15 Year,0.03
60,288112.84,2762.33,720.28,2042.05,286070.79,15 Year,0.03
61,286070.79,2762.33,715.17,2047.16,284023.63,15 Year,0.03
62,284023.63,2762.33,710.05,2052.28,281971.35,15 Year,0.03
63,281971.35,2762.33,704.92,2057.41,279913.94,15 Year,0.03
64,279913.94,2762.33,699.78,2062.55,277851.39,15 Year,0.03
65,277851.39,2762.33,694.62,2067.71,275783.68,15 Year,0.03
66,275783.68,2762.33,689.45,2072.88,273710.8,15 Year,0.03
67,273710.8,2762.33,684.27,2078.06,271632.74,15 Year,0.03
68,271632.74,2762.33,679.08,2083.25,269549.49,15 Year,0.03
69,269549.49,2762.33,673.87,2088.46,267461.03,15 Year,0.03
70,267461.03,2762.33,668.65,2093.68,265367.35,15 Year,0.03
71,265367.35,2762.33,663.41,2098.92,263268.43,15 Year,0.03
72,263268.43,2762.33,658.17,2104.16,261164.27,15 Year,0.03
73,261164.27,2762.33,652.91,2109.42,259054.85,15 Year,0.03
74,259054.85,2762.33,647.63,2114.7,256940.15,15 Year,0.03
75,256940.15,2762.33,642.35,2119.98,254820.17,15 Year,0.03
76,254820.17,2762.33,637.05,2125.28,252694.89,15 Year,0.03
77,252694.89,2762.33,631.73,2130.6,250564.29,15 Year,0.03
78,250564.29,2762.33,626.41,2135.92,248428.37,15 Year,0.03
79,248428.37,2762.33,621.07,2141.26,246287.11,15 Year,0.03
80,246287.11,2762.33,615.71,2146.62,244140.49,15 Year,0.03
81,244140.49,2762.33,610.35,2151.98,241988.51,15 Year,0.03
82,241988.51,2762.33,604.97,2157.36,239831.15,15 Year,0.03
83,239831.15,2762.33,599.57,2162.76,237668.39,15 Year,0.03
84,237668.39,2762.33,594.17,2168.16,235500.23,15 Year,0.03
85,235500.23,2762.33,588.75,2173.58,233326.65,15 Year,0.03
86,233326.65,2762.33,583.31,2179.02,231147.63,15 Year,0.03
87,231147.63,2762.33,577.86,2184.47,228963.16,15 Year,0.03
88,228963.16,2762.33,572.4,2189.93,226773.23,15 Year,0.03
89,226773.23,2762.33,566.93,2195.4,224577.83,15 Year,0.03
90,224577.83,2762.33,561.44,2200.89,222376.94,15 Year,0.03
91,222376.94,2762.33,555.94,2206.39,220170.55,15 Year,0.03
92,220170.55,2762.33,550.42,2211.91,217958.64,15 Year,0.03
93,217958.64,2762.33,544.89,2217.44,215741.2,15 Year,0.03
94,215741.2,2762.33,539.35,2222.98,213518.22,15 Year,0.03
95,213518.22,2762.33,533.79,2228.54,211289.68,15 Year,0.03
96,211289.68,2762.33,528.22,2234.11,209055.57,15 Year,0.03
97,209055.57,2762.33,522.63,2239.7,206815.87,15 Year,0.03
98,206815.87,2762.33,517.03,2245.3,204570.57,15 Year,0.03
99,204570.57,2762.33,511.42,2250.91,202319.66,15 Year,0.03
100,202319.66,2762.33,505.79,2256.54,200063.12,15 Year,0.03
101,200063.12,2762.33,500.15,2262.18,197800.94,15 Year,0.03
102,197800.94,2762.33,494.5,2267.83,195533.11,15 Year,0.03
103,195533.11,2762.33,488.83,2273.5,193259.61,15 Year,0.03
104,193259.61,2762.33,483.14,2279.19,190980.42,15 Year,0.03
105,190980.42,2762.33,477.45,2284.88,188695.54,15 Year,0.03
106,188695.54,2762.33,471.73,2290.6,186404.94,15 Year,0.03
107,186404.94,2762.33,466.01,2296.32,184108.62,15 Year,0.03
108,184108.62,2762.33,460.27,2302.06,181806.56,15 Year,0.03
109,181806.56,2762.33,454.51,2307.82,179498.74,15 Year,0.03
110,179498.74,2762.33,448.74,2313.59,177185.15,15 Year,0.03
111,177185.15,2762.33,442.96,2319.37,174865.78,15 Year,0.03
112,174865.78,2762.33,437.16,2325.17,172540.61,15 Year,0.03
113,172540.61,2762.33,431.35,2330.98,170209.63,15 Year,0.03
114,170209.63,2762.33,425.52,2336.81,167872.82,15 Year,0.03
115,167872.82,2762.33,419.68,2342.65,165530.17,15 Year,0.03
116,165530.17,2762.33,413.82,2348.51,163181.66,15 Year,0.03
117,163181.66,2762.33,407.95,2354.38,160827.28,15 Year,0.03
118,160827.28,2762.33,402.06,2360.27,158467.01,15 Year,0.03
119,158467.01,2762.33,396.16,2366.17,156100.84,15 Year,0.03
120,156100.84,2762.33,390.25,2372.08,153728.76,15 Year,0.03
121,153728.76,2762.33,384.32,2378.01,151350.75,15 Year,0.03
122,151350.75,2762.33,378.37,2383.96,148966.79,15 Year,0.03
123,148966.79,2762.33,372.41,2389.92,146576.87,15 Year,0.03
124,146576.87,2762.33,366.44,2395.89,144180.98,15 Year,0.03
125,144180.98,2762.33,360.45,2401.88,141779.1,15 Year,0.03
126,141779.1,2762.33,354.44,2407.89,139371.21,15 Year,0.03
127,139371.21,2762.33,348.42,2413.91,136957.3,15 Year,0.03
128,136957.3,2762.33,342.39,2419.94,134537.36,15 Year,0.03
129,134537.36,2762.33,336.34,2425.99,132111.37,15 Year,0.03
130,132111.37,2762.33,330.27,2432.06,129679.31,15 Year,0.03
131,129679.31,2762.33,324.19,2438.14,127241.17,15 Year,0.03
132,127241.17,2762.33,318.1,2444.23,124796.94,15 Year,0.03
133,124796.94,2762.33,311.99,2450.34,122346.6,15 Year,0.03
134,122346.6,2762.33,305.86,2456.47,119890.13,15 Year,0.03
135,119890.13,2762.33,299.72,2462.61,117427.52,15 Year,0.03
136,117427.52,2762.33,293.56,2468.77,114958.75,15 Year,0.03
137,114958.75,2762.33,287.39,2474.94,112483.81,15 Year,0.03
138,112483.81,2762.33,281.2,2481.13,110002.68,15 Year,0.03
139,110002.68,2762.33,275.0,2487.33,107515.35,15 Year,0.03
140,107515.35,2762.33,268.78,2493.55,105021.8,15 Year,0.03
141,105021.8,2762.33,262.55,2499.78,102522.02,15 Year,0.03
142,102522.02,2762.33,256.3,2506.03,100015.99,15 Year,0.03
143,100015.99,2762.33,250.03,2512.3,97503.69,15 Year,0.03
144,97503.69,2762.33,243.75,2518.58,94985.11,15 Year,0.03
145,94985.11,2762.33,237.46,2524.87,92460.24,15 Year,0.03
146,92460.24,2762.33,231.15,2531.18,89929.06,15 Year,0.03
147,89929.06,2762.33,224.82,2537.51,87391.55,15 Year,0.03
148,87391.55,2762.33,218.47,2543.86,84847.69,15 Year,0.03
149,84847.69,2762.33,212.11,2550.22,82297.47,15 Year,0.03
150,82297.47,2762.33,205.74,2556.59,79740.88,15 Year,0.03
151,79740.88,2762.33,199.35,2562.98,77177.9,15 Year,0.03
152,77177.9,2762.33,192.94,2569.39,74608.51,15 Year,0.03
153,74608.51,2762.33,186.52,2575.81,72032.7,15 Year,0.03
154,72032.7,2762.33,180.08,2582.25,69450.45,15 Year,0.03
155,69450.45,2762.33,173.62,2588.71,66861.74,15 Year,0.03
156,66861.74,2762.33,167.15,2595.18,64266.56,15 Year,0.03
157,64266.56,2762.33,160.66,2601.67,61664.89,15 Year,0.03
158,61664.89,2762.33,154.16,2608.17,59056.72,15 Year,0.03
159,59056.72,2762.33,147.64,2614.69,56442.03,15 Year,0.03
160,56442.03,2762.33,141.1,2621.23,53820.8,15 Year,0.03
161,53820.8,2762.33,134.55,2627.78,51193.02,15 Year,0.03
162,51193.02,2762.33,127.98,2634.35,48558.67,15 Year,0.03
163,48558.67,2762.33,121.39,2640.94,45917.73,15 Year,0.03
164,45917.73,2762.33,114.79,2647.54,43270.19,15 Year,0.03
165,43270.19,2762.33,108.17,2654.16,40616.03,15 Year,0.03
166,40616.03,2762.33,101.54,2660.79,37955.24,15 Year,0.03
167,37955.24,2762.33,94.88,2667.45,35287.79,15 Year,0.03
168,35287.79,2762.33,88.21,2674.12,32613.67,15 Year,0.03
169,32613.67,2762.33,81.53,2680.8,29932.87,15 Year,0.03
170,29932.87,2762.33,74.83,2687.5,27245.37,15 Year,0.03
171,27245.37,2762.33,68.11,2694.22,24551.15,15 Year,0.03
172,24551.15,2762.33,61.37,2700.96,21850.19,15 Year,0.03
173,21850.19,2762.33,54.62,2707.71,19142.48,15 Year,0.03
174,19142.48,2762.33,47.85,2714.48,16428.0,15 Year,0.03
175,16428.0,2762.33,41.07,2721.26,13706.74,15 Year,0.03
176,13706.74,2762.33,34.26,2728.07,10978.67,15 Year,0.03
177,10978.67,2762.33,27.44,2734.89,8243.78,15 Year,0.03
178,8243.78,2762.33,20.6,2741.73,5502.05,15 Year,0.03
179,5502.05,2762.33,13.75,2748.58,2753.47,15 Year,0.03
180,2753.47,2762.33,6.88,2755.45,-1.98,15 Year,0.03
1,400000.0,3163.17,1666.66,1496.51,398503.49,15 Year,0.05
2,398503.49,3163.17,1660.43,1502.74,397000.75,15 Year,0.05
3,397000.75,3163.17,1654.16,1509.01,395491.74,15 Year,0.05
4,395491.74,3163.17,1647.88,1515.29,393976.45,15 Year,0.05
5,393976.45,3163.17,1641.56,1521.61,392454.84,15 Year,0.05
6,392454.84,3163.17,1635.22,1527.95,390926.89,15 Year,0.05
7,390926.89,3163.17,1628.86,1534.31,389392.58,15 Year,0.05
8,389392.58,3163.17,1622.46,1540.71,387851.87,15 Year,0.05
9,387851.87,3163.17,1616.04,1547.13,386304.74,15 Year,0.05
10,386304.74,3163.17,1609.6,1553.57,384751.17,15 Year,0.05
11,384751.17,3163.17,1603.12,1560.05,383191.12,15 Year,0.05
12,383191.12,3163.17,1596.62,1566.55,381624.57,15 Year,0.05
13,381624.57,3163.17,1590.1,1573.07,380051.5,15 Year,0.05
14,380051.5,3163.17,1583.54,1579.63,378471.87,15 Year,0.05
15,378471.87,3163.17,1576.96,1586.21,376885.66,15 Year,0.05
16,376885.66,3163.17,1570.35,1592.82,375292.84,15 Year,0.05
17,375292.84,3163.17,1563.72,1599.45,373693.39,15 Year,0.05
18,373693.39,3163.17,1557.05,1606.12,372087.27,15 Year,0.05
19,372087.27,3163.17,1550.36,1612.81,370474.46,15 Year,0.05
20,370474.46,3163.17,1543.64,1619.53,368854.93,15 Year,0.05
21,368854.93,3163.17,1536.89,1626.28,367228.65,15 Year,0.05
22,367228.65,3163.17,1530.11,1633.06,365595.59,15 Year,0.05
23,365595.59,3163.17,1523.31,1639.86,363955.73,15 Year,0.05
24,363955.73,3163.17,1516.48,1646.69,362309.04,15 Year,0.05
25,362309.04,3163.17,1509.62,1653.55,360655.49,15 Year,0.05
26,360655.49,3163.17,1502.73,1660.44,358995.05,15 Year,0.05
27,358995.05,3163.17,1495.81,1667.36,357327.69,15 Year,0.05
28,357327.69,3163.17,1488.86,1674.31,355653.38,15 Year,0.05
29,355653.38,3163.17,1481.88,1681.29,353972.09,15 Year,0.05
30,353972.09,3163.17,1474.88,1688.29,352283.8,15 Year,0.05
31,352283.8,3163.17,1467.84,1695.33,350588.47,15 Year,0.05
32,350588.47,3163.17,1460.78,1702.39,348886.08,15 Year,0.05
33,348886.08,3163.17,1453.69,1709.48,347176.6,15 Year,0.05
34,347176.6,3163.17,1446.56,1716.61,345459.99,15 Year,0.05
35,345459.99,3163.17,1439.41,1723.76,343736.23,15 Year,0.05
36,343736.23,3163.17,1432.23,1730.94,342005.29,15 Year,0.05
37,342005.29,3163.17,1425.02,1738.15,340267.14,15 Year,0.05
38,340267.14,3163.17,1417.77,1745.4,338521.74,15 Year,0.05
39,338521.74,3163.17,1410.5,1752.67,336769.07,15 Year,0.05
40,336769.07,3163.17,1403.2,1759.97,335009.1,15 Year,0.05
41,335009.1,3163.17,1395.87,1767.3,333241.8,15 Year,0.05
42,333241.8,3163.17,1388.5,1774.67,331467.13,15 Year,0.05
43,331467.13,3163.17,1381.11,1782.06,329685.07,15 Year,0.05
44,329685.07,3163.17,1373.68,1789.49,327895.58,15 Year,0.05
45,327895.58,3163.17,1366.23,1796.94,326098.64,15 Year,0.05
46,326098.64,3163.17,1358.74,1804.43,324294.21,15 Year,0.05
47,324294.21,3163.17,1351.22,1811.95,322482.26,15 Year,0.05
48,322482.26,3163.17,1343.67,1819.5,320662.76,15 Year,0.05
49,320662.76,3163.17,1336.09,1827.08,318835.68,15 Year,0.05
50,318835.68,3163.17,1328.48,1834.69,317000.99,15 Year,0.05
51,317000.99,3163.17,1320.83,1842.34,315158.65,15 Year,0.05
52,315158.65,3163.17,1313.16,1850.01,313308.64,15 Year,0.05
53,313308.64,3163.17,1305.45,1857.72,311450.92,15 Year,0.05
54,311450.92,3163.17,1297.71,1865.46,309585.46,15 Year,0.05
55,309585.46,3163.17,1289.93,1873.24,307712.22,15 Year,0.05
56,307712.22,3163.17,1282.13,1881.04,305831.18,15 Year,0.05
57,305831.18,3163.17,1274.29,1888.88,303942.3,15 Year,0.05
58,303942.3,3163.17,1266.42,1896.75,302045.55,15 Year,0.05
59,302045.55,3163.17,1258.52,1904.65,300140.9,15 Year,0.05
60,300140.9,3163.17,1250.58,1912.59,298228.31,15 Year,0.05
61,298228.31,3163.17,1242.61,1920.56,296307.75,15 Year,0.05
62,296307.75,3163.17,1234.61,1928.56,294379.19,15 Year,0.05
63,294379.19,3163.17,1226.57,1936.6,292442.59,15 Year,0.05
64,292442.59,3163.17,1218.51,1944.66,290497.93,15 Year,0.05
65,290497.93,3163.17,1210.4,1952.77,288545.16,15 Year,0.05
66,288545.16,3163.17,1202.27,1960.9,286584.26,15 Year,0.05
67,286584.26,3163.17,1194.1,1969.07,284615.19,15 Year,0.05
68,284615.19,3163.17,1185.89,1977.28,282637.91,15 Year,0.05
69,282637.91,3163.17,1177.65,1985.52,280652.39,15 Year,0.05
70,280652.39,3163.17,1169.38,1993.79,278658.6,15 Year,0.05
71,278658.6,3163.17,1161.07,2002.1,276656.5,15 Year,0.05
72,276656.5,3163.17,1152.73,2010.44,274646.06,15 Year,0.05
73,274646.06,3163.17,1144.35,2018.82,272627.24,15 Year,0.05
74,272627.24,3163.17,1135.94,2027.23,270600.01,15 Year,0.05
75,270600.01,3163.17,1127.5,2035.67,268564.34,15 Year,0.05
76,268564.34,3163.17,1119.01,2044.16,266520.18,15 Year,0.05
77,266520.18,3163.17,1110.5,2052.67,264467.51,15 Year,0.05
78,264467.51,3163.17,1101.94,2061.23,262406.28,15 Year,0.05
79,262406.28,3163.17,1093.35,2069.82,260336.46,15 Year,0.05
80,260336.46,3163.17,1084.73,2078.44,258258.02,15 Year,0.05
81,258258.02,3163.17,1076.07,2087.1,256170.92,15 Year,0.05
82,256170.92,3163.17,1067.37,2095.8,254075.12,15 Year,0.05
83,254075.12,3163.17,1058.64,2104.53,251970.59,15 Year,0.05
84,251970.59,3163.17,1049.87,2113.3,249857.29,15 Year,0.05
85,249857.29,3163.17,1041.07,2122.1,247735.19,15 Year,0.05
86,247735.19,3163.17,1032.22,2130.95,245604.24,15 Year,0.05
87,245604.24,3163.17,1023.35,2139.82,243464.42,15 Year,0.05
88,243464.42,3163.17,1014.43,2148.74,241315.68,15 Year,0.05
89,241315.68,3163.17,1005.48,2157.69,239157.99,15 Year,0.05
90,239157.99,3163.17,996.49,2166.68,236991.31,15 Year,0.05
91,236991.31,3163.17,987.46,2175.71,234815.6,15 Year,0.05
92,234815.6,3163.17,978.39,2184.78,232630.82,15 Year,0.05
93,232630.82,3163.17,969.29,2193.88,230436.94,15 Year,0.05
94,230436.94,3163.17,960.15,2203.02,228233.92,15 Year,0.05
95,228233.92,3163.17,950.97,2212.2,226021.72,15 Year,0.05
96,226021.72,3163.17,941.75,2221.42,223800.3,15 Year,0.05
97,223800.3,3163.17,932.5,2230.67,221569.63,15 Year,0.05
98,221569.63,3163.17,923.2,2239.97,219329.66,15 Year,0.05
99,219329.66,3163.17,913.87,2249.3,217080.36,15 Year,0.05
100,217080.36,3163.17,904.5,2258.67,214821.69,15 Year,0.05
101,214821.69,3163.17,895.09,2268.08,212553.61,15 Year,0.05
102,212553.61,3163.17,885.64,2277.53,210276.08,15 Year,0.05
103,210276.08,3163.17,876.15,2287.02,207989.06,15 Year,0.05
104,207989.06,3163.17,866.62,2296.55,205692.51,15 Year,0.05
105,205692.51,3163.17,857.05,2306.12,203386.39,15 Year,0.05
106,203386.39,3163.17,847.44,2315.73,201070.66,15 Year,0.05
107,201070.66,3163.17,837.79,2325.38,198745.28,15 Year,0.05
108,198745.28,3163.17,828.1,2335.07,196410.21,15 Year,0.05
109,196410.21,3163.17,818.37,2344.8,194065.41,15 Year,0.05
110,194065.41,3163.17,808.6,2354.57,191710.84,15 Year,0.05
111,191710.84,3163.17,798.79,2364.38,189346.46,15 Year,0.05
112,189346.46,3163.17,788.94,2374.23,186972.23,15 Year,0.05
113,186972.23,3163.17,779.05,2384.12,184588.11,15 Year,0.05
114,184588.11,3163.17,769.11,2394.06,182194.05,15 Year,0.05
115,182194.05,3163.17,759.14,2404.03,179790.02,15 Year,0.05
116,179790.02,3163.17,749.12,2414.05,177375.97,15 Year,0.05
117,177375.97,3163.17,739.06,2424.11,174951.86,15 Year,0.05
118,174951.86,3163.17,728.96,2434.21,172517.65,15 Year,0.05
119,172517.65,3163.17,718.82,2444.35,170073.3,15 Year,0.05
120,170073.3,3163.17,708.63,2454.54,167618.76,15 Year,0.05
121,167618.76,3163.17,698.41,2464.76,165154.0,15 Year,0.05
122,165154.0,3163.17,688.14,2475.03,162678.97,15 Year,0.05
123,162678.97,3163.17,677.82,2485.35,160193.62,15 Year,0.05
124,160193.62,3163.17,667.47,2495.7,157697.92,15 Year,0.05
125,157697.92,3163.17,657.07,2506.1,155191.82,15 Year,0.05
126,155191.82,3163.17,646.63,2516.54,152675.28,15 Year,0.05
127,152675.28,3163.17,636.14,2527.03,150148.25,15 Year,0.05
128,150148.25,3163.17,625.61,2537.56,147610.69,15 Year,0.05
129,147610.69,3163.17,615.04,2548.13,145062.56,15 Year,0.05
130,145062.56,3163.17,604.42,2558.75,142503.81,15 Year,0.05
131,142503.81,3163.17,593.76,2569.41,139934.4,15 Year,0.05
132,139934.4,3163.17,583.05,2580.12,137354.28,15 Year,0.05
133,137354.28,3163.17,572.3,2590.87,134763.41,15 Year,0.05
134,134763.41,3163.17,561.51,2601.66,132161.75,15 Year,0.05
135,132161.75,3163.17,550.67,2612.5,129549.25,15 Year,0.05
136,129549.25,3163.17,539.78,2623.39,126925.86,15 Year,0.05
137,126925.86,3163.17,528.85,2634.32,124291.54,15 Year,0.05
138,124291.54,3163.17,517.88,2645.29,121646.25,15 Year,0.05
139,121646.25,3163.17,506.85,2656.32,118989.93,15 Year,0.05
140,118989.93,3163.17,495.79,2667.38,116322.55,15 Year,0.05
141,116322.55,3163.17,484.67,2678.5,113644.05,15 Year,0.05
142,113644.05,3163.17,473.51,2689.66,110954.39,15 Year,0.05
143,110954.39,3163.17,462.3,2700.87,108253.52,15 Year,0.05
144,108253.52,3163.17,451.05,2712.12,105541.4,15 Year,0.05
145,105541.4,3163.17,439.75,2723.42,102817.98,15 Year,0.05
146,102817.98,3163.17,428.4,2734.77,100083.21,15 Year,0.05
147,100083.21,3163.17,417.01,2746.16,97337.05,15 Year,0.05
148,97337.05,3163.17,405.57,2757.6,94579.45,15 Year,0.05
149,94579.45,3163.17,394.08,2769.09,91810.36,15 Year,0.05
150,91810.36,3163.17,382.54,2780.63,89029.73,15 Year,0.05
151,89029.73,3163.17,370.95,2792.22,86237.51,15 Year,0.05
152,86237.51,3163.17,359.32,2803.85,83433.66,15 Year,0.05
153,83433.66,3163.17,347.64,2815.53,80618.13,15 Year,0.05
154,80618.13,3163.17,335.9,2827.27,77790.86,15 Year,0.05
155,77790.86,3163.17,324.12,2839.05,74951.81,15 Year,0.05
156,74951.81,3163.17,312.29,2850.88,72100.93,15 Year,0.05
157,72100.93,3163.17,300.42,2862.75,69238.18,15 Year,0.05
158,69238.18,3163.17,288.49,2874.68,66363.5,15 Year,0.05
159,66363.5,3163.17,276.51,2886.66,63476.84,15 Year,0.05
160,63476.84,3163.17,264.48,2898.69,60578.15,15 Year,0.05
161,60578.15,3163.17,252.4,2910.77,57667.38,15 Year,0.05
162,57667.38,3163.17,240.28,2922.89,54744.49,15 Year,0.05
163,54744.49,3163.17,228.1,2935.07,51809.42,15 Year,0.05
164,51809.42,3163.17,215.87,2947.3,48862.12,15 Year,0.05
165,48862.12,3163.17,203.59,2959.58,45902.54,15 Year,0.05
166,45902.54,3163.17,191.26,2971.91,42930.63,15 Year,0.05
167,42930.63,3163.17,178.87,2984.3,39946.33,15 Year,0.05
168,39946.33,3163.17,166.44,2996.73,36949.6,15 Year,0.05
169,36949.6,3163.17,153.95,3009.22,33940.38,15 Year,0.05
170,33940.38,3163.17,141.41,3021.76,30918.62,15 Year,0.05
171,30918.62,3163.17,128.82,3034.35,27884.27,15 Year,0.05
172,27884.27,3163.17,116.18,3046.99,24837.28,15 Year,0.05
173,24837.28,3163.17,103.48,3059.69,21777.59,15 Year,0.05
174,21777.59,3163.17,90.73,3072.44,18705.15,15 Year,0.05
175,18705.15,3163.17,77.93,3085.24,15619.91,15 Year,0.05
176,15619.91,3163.17,65.08,3098.09,12521.82,15 Year,0.05
177,12521.82,3163.17,52.17,3111.0,9410.82,15 Year,0.05
178,9410.82,3163.17,39.21,3123.96,6286.86,15 Year,0.05
179,6286.86,3163.17,26.19,3136.98,3149.88,15 Year,0.05
180,3149.88,3163.17,13.12,3150.05,-0.17,15 Year,0.05
